BBEEEEEBB
BBBBBBBBB
BEEEEEEEB
BBBBBBBBB
EBBEEEBBE
EEEEEEEEE
BBBBBBBBB