BBEEEEEBB
BBBBBBBBB
BEEEBEEEB
BBBBBBBBB
EBBEEEBBE
EEEEEEEEE
BBBBBBBBB